10
10
##########
######-###
####+++###
##########
##########
###-######
##########
##########
##########
##########